""""""""""""
"  J       "
"     C    "
"    D     "
""""""""""""
