##########
#P   XO  #
# XO     #
#    OX  #
##########
